ABW	Abbey Wood
ABE	Aber
ACY	Abercynon
ABA	Aberdare
ABD	Aberdeen
AUR	Aberdour
AVY	Aberdovey
ABH	Abererch
AGV	Abergavenny
AGL	Abergele & Pensarn
AYW	Aberystwyth
ACR	Accrington
AAT	Achanalt
ACN	Achnasheen
ACH	Achnashellach
ACK	Acklington
ACL	Acle
ACG	Acocks Green
ACB	Acton Bridge
ACC	Acton Central
AML	Acton Main Line
ADD	Adderley Park
ADW	Addiewell
ASN	Addlestone
ADM	Adisham
ADC	Adlington (Cheshire)
ADL	Adlington (Lancashire)
AWK	Adwick
AIG	Aigburth
ANS	Ainsdale
AIN	Aintree
AIR	Airbles
ADR	Airdrie
AYP	Albany Park
ALB	Albrighton
ALD	Alderley Edge
AMT	Aldermaston
AHT	Aldershot
AGT	Aldrington
AAP	Alexandra Palace
AXP	Alexandra Parade
ALX	Alexandria
ALF	Alfreton
ALW	Allen's West
ALO	Alloa
ASS	Alness
ALM	Alnmouth
ALR	Alresford
ASG	Alsager
ALN	Althorne
ALP	Althorpe
ABC	Altnabreac
AON	Alton
ALT	Altrincham
ALV	Alvechurch
AMB	Ambergate
AMY	Amberley
AMR	Amersham
AMF	Ammanford
ANC	Ancaster
AND	Anderston
ADV	Andover
ANY	Anerley
AGR	Angel Road
ANG	Angmering
ANN	Annan
ANL	Anniesland
AFV	Ansdell & Fairhaven
APP	Appleby
APD	Appledore
APF	Appleford
APB	Appley Bridge
APS	Apsley
ARB	Arbroath
ARD	Ardgay
AUI	Ardlui
ADS	Ardrossan Harbour
ASB	Ardrossan South Beach
ADN	Ardrossan Town
ADK	Ardwick
AGS	Argyle Street
ARG	Arisaig
ARL	Arlesey
ARM	Armadale
AWT	Armathwaite
ARN	Arnside
ARR	Arram
ART	Arrochar & Tarbet
ARU	Arundel
ACT	Ascot (BERKS)
AUW	Ascott-Under-Wychwood
ASH	Ash
AHV	Ash Vale
ABY	Ashburys
ASC	Ashchurch
ASF	Ashfield
AFS	Ashford (Middlesex)
AFK	Ashford INTL
ASY	Ashley
AHD	Ashtead
AHN	Ashton-Under-Lyne
AHS	Ashurst
ANF	Ashurst New Forest
AWM	Ashwell & Morden
ASK	Askam
ALK	Aslockton
ASP	Aspatria
APG	Aspley Guise
AST	Aston
ATH	Atherstone
ATN	Atherton
ATT	Attadale
ATB	Attenborough
ATL	Attleborough
AUK	Auchinleck
AUD	Audley End
AUG	Aughton Park
AVM	Aviemore
AVF	Avoncliff
AVN	Avonmouth
AXM	Axminster
AYS	Aylesbury
AVP	Aylesbury Vale Parkway
AYL	Aylesford
AYH	Aylesham
AYR	Ayr
BAC	Bache
BAJ	Baglan
BAG	Bagshot
BLD	Baildon
BIO	Baillieston
BAB	Balcombe
BDK	Baldock
BAL	Balham
BHC	Balloch
BSI	Balmossie
BMB	Bamber Bridge
BAM	Bamford
BNV	Banavie
BAN	Banbury
BNG	Bangor (Gwynedd)
BAH	Bank Hall
BAD	Banstead
BSS	Barassie
BLL	Bardon Mill
BAR	Bare Lane
BGI	Bargeddie
BGD	Bargoed
BKG	Barking
BMG	Barming
BRM	Barmouth
BNH	Barnehurst
BNS	Barnes
BNI	Barnes Bridge
BTB	Barnetby
BAA	Barnham
BNL	Barnhill
BNY	Barnsley
BNP	Barnstaple
BTG	Barnt Green
BRR	Barrhead
BRL	Barrhill
BAV	Barrow Haven
BIF	Barrow-In-Furness
BWS	Barrow-Upon-Soar
BRY	Barry
BYD	Barry Docks
BYI	Barry Island
BYL	Barry Links
BAU	Barton-On-Humber
BSO	Basildon
BSK	Basingstoke
BBL	Bat & Ball
BTH	Bath Spa
BHG	Bathgate
BTL	Batley
BTT	Battersby
BAK	Battersea Park
BAT	Battle
BLB	Battlesbridge
BAY	Bayford
BCF	Beaconsfield
BER	Bearley
BRN	Bearsden
BSD	Bearsted
BSL	Beasdale
BEU	Beaulieu Road
BEL	Beauly
BEB	Bebington
BCC	Beccles
BEC	Beckenham Hill
BKJ	Beckenham Jn
BDM	Bedford
BSJ	Bedford St.Johns
BDH	Bedhampton
BMT	Bedminster
BEH	Bedworth
BDW	Bedwyn
BEE	Beeston
BKS	Bekesbourne
BLV	Belle Vue
BLG	Bellgrove
BGM	Bellingham
BLH	Bellshill
BLM	Belmont
BLP	Belper
BEG	Beltring
BVD	Belvedere
BEM	Bempton
BEY	Ben Rhydding
BEF	Benfleet
BEN	Bentham
BTY	Bentley
BYK	Bentley (S. Yorks)
BAS	Bere Alston
BFE	Bere Ferrers
BKM	Berkhamsted
BKW	Berkswell
BYA	Berney Arms
BBW	Berry Brow
BRS	Berrylands
BRK	Berwick (Sussex)
BWK	Berwick-Upon-Tweed
BES	Bescar Lane
BSC	Bescot Stadium
BTO	Betchworth
BET	Bethnal Green
BYC	Betws-y-Coed
BEV	Beverley
BEX	Bexhill
BXY	Bexley
BXH	Bexleyheath
BCS	Bicester North
BIT	Bicester Town
BKL	Bickley
BID	Bidston
BIW	Biggleswade
BBK	Bilbrook
BIC	Billericay
BIL	Billingham
BIG	Billingshurst
BIN	Bingham
BIY	Bingley
BCG	Birchgrove
BCH	Birchington-On-Sea
BWD	Birchwood
BIK	Birkbeck
BDL	Birkdale
BKC	Birkenhead Central
BKQ	Birkenhead Hamilton Square
BKN	Birkenhead North
BKP	Birkenhead Park
BBS	Birmingham Bordesley
BHI	Birmingham International
BMO	Birmingham Moor Street
BHM	Birmingham
BSW	Birmingham Snow Hill
BIA	Bishop Auckland
BBG	Bishopbriggs
BIS	Bishops Stortford
BIP	Bishopstone
BPT	Bishopton
BTE	Bitterne
BBN	Blackburn
BFR	Blackfriars
BKH	Blackheath
BHO	Blackhorse Road
BPN	Blackpool North
BPB	Blackpool Pleasure Beach
BPS	Blackpool South
BKR	Blackridge
BLK	Blackrod
BAW	Blackwater
BFF	Blaenau Ffestiniog
BLA	Blair Atholl
BAI	Blairhill
BKT	Blake Street
BKD	Blakedown
BLT	Blantyre
BLO	Blaydon
BSB	Bleasby
BLY	Bletchley
BLX	Bloxwich
BWN	Bloxwich North
BLN	Blundellsands & Crosby
BYB	Blythe Bridge
BOD	Bodmin Parkway
BOR	Bodorgan
BOG	Bognor Regis
BGS	Bogston
BON	Bolton
BTD	Bolton-On-Dearne
BKA	Bookham
BOC	Bootle (Cumbria)
BNW	Bootle New Strand
BOT	Bootle Oriel Road
BRG	Borough Green & Wrotham
BRH	Borth
BOH	Bosham
BSN	Boston
BOE	Botley
BTF	Bottesford
BNE	Bourne End
BMH	Bournemouth
BRV	Bournville
BWB	Bow Brickhill
BOP	Bowes Park
BWG	Bowling
BXW	Boxhill & Westhumble
BCE	Bracknell
BDQ	Bradford
BDI	Bradford Interchange
BOA	Bradford-On-Avon
BDN	Brading
BTR	Braintree
BTP	Braintree Freeport
BML	Bramhall
BMY	Bramley (Hampshire)
BLE	Bramley (West Yorkshire)
BMP	Brampton (Cumbria)
BRP	Brampton (Suffolk)
BCN	Branchton
BND	Brandon
BSM	Branksome
BYS	Braystones
BDY	Bredbury
BRC	Breich
BFD	Brentford
BRE	Brentwood
BWO	Bricket Wood
BEA	Bridge Of Allan
BRO	Bridge Of Orchy
BGN	Bridgend
BDG	Bridgeton
BWT	Bridgwater
BDT	Bridlington
BRF	Brierfield
BGG	Brigg
BGH	Brighouse
BTN	Brighton
BMD	Brimsdown
BNT	Brinnington
BPW	Bristol Parkway
BRI	Bristol
BHD	Brithdir
RBS	British Steel Redcar
BNF	Briton Ferry
BRX	Brixton
BGE	Broad Green
BDB	Broadbottom
BSR	Broadstairs
BCU	Brockenhurst
BHS	Brockholes
BCY	Brockley
BOM	Bromborough
BMR	Bromborough Rake
BMC	Bromley Cross
BMN	Bromley North
BMS	Bromley South
BMV	Bromsgrove
BSY	Brondesbury
BSP	Brondesbury Park
BPK	Brookman's Park
BKO	Brookwood
BME	Broome
BMF	Broomfleet
BRA	Brora
BUH	Brough
BYF	Broughty Ferry
BXB	Broxbourne
BCV	Bruce Grove
BDA	Brundall
BGA	Brundall Gardens
BSU	Brunstane
BRW	Brunswick
BRU	Bruton
BYN	Bryn
BUC	Buckenham
BCK	Buckley
BUK	Bucknell
BGL	Bugle
BHR	Builth Road
BLW	Bulwell
BUE	Bures
BUG	Burgess Hill
BUY	Burley Park
BUW	Burley-In-Wharfedale
BNA	Burnage
BUD	Burneside
BNM	Burnham
BUU	Burnham-On-Crouch
BUB	Burnley Barracks
BNC	Burnley Central
BYM	Burnley Manchester Road
BUI	Burnside
BTS	Burntisland
BCB	Burscough Bridge
BCJ	Burscough Junction
BUO	Bursledon
BUJ	Burton Joyce
BUT	Burton-On-Trent
BSE	Bury St.Edmunds
BUS	Busby
BHK	Bush Hill Park
BSH	Bushey
BUL	Butlers Lane
BPC	Butlins Penychain
BXD	Buxted
BUX	Buxton
BFN	Byfleet & New Haw
BYE	Bynea
CAD	Cadoxton
CGW	Caergwrle
CPH	Caerphilly
CWS	Caersws
CAC	Caldercruix
CDT	Caldicot
CIR	Caledonian Road & Barnsbury
CSK	Calstock
CDU	Cam & Dursley
CAM	Camberley
CBN	Camborne
CBG	Cambridge
CBH	Cambridge Heath
CBL	Cambuslang
CMD	Camden Road
CMO	Camelon
CAW	Canada Water
CNL	Canley
CAO	Cannock
CST	Cannon Street
CNN	Canonbury
CBE	Canterbury East
CBW	Canterbury West
CNY	Cantley
CPU	Capenhurst
CBB	Carbis Bay
CDD	Cardenden
CDB	Cardiff Bay
CDF	Cardiff Central
CDQ	Cardiff Queen Street
CDO	Cardonald
CDR	Cardross
CRF	Carfin
CAK	Cark & Cartmel
CAR	Carlisle
CTO	Carlton
CLU	Carluke
CMN	Carmarthen
CML	Carmyle
CNF	Carnforth
CAN	Carnoustie
CAY	Carntyne
CPK	Carpenders Park
CAG	Carrbridge
CSH	Carshalton
CSB	Carshalton Beeches
CRS	Carstairs
CDY	Cartsdyke
CBP	Castle Bar Park
CLC	Castle Cary
CFD	Castleford
CAS	Castleton
CSM	Castleton Moor
CAT	Caterham
CTF	Catford
CFB	Catford Bridge
CYS	Cathays
CCT	Cathcart
CTL	Cattal
CAU	Causeland
CYB	Cefn-Y-Bedd
CTH	Chadwell Heath
CFH	Chafford Hundred
CFO	Chalfont & Latimer
CHW	Chalkwell
CFR	Chandlers Ford
CEF	Chapel-En-Le-Frith
CPN	Chapelton
CLN	Chapeltown
CWC	Chappel & Wakes Colne
CHG	Charing
CHX	Charing Cross
CHC	Charing Cross (Glasgow)
CBY	Charlbury
CTN	Charlton
CRT	Chartham
CSR	Chassen Road
CTE	Chatelherault
CTM	Chatham
CHT	Chathill
CHU	Cheadle Hulme
CHE	Cheam
CED	Cheddington
CEL	Chelford
CHM	Chelmsford
CLD	Chelsfield
CNM	Cheltenham Spa
CPW	Chepstow
CYT	Cherry Tree
CHY	Chertsey
CHN	Cheshunt
CSN	Chessington North
CSS	Chessington South
CTR	Chester
CRD	Chester Road
CLS	Chester-Le-Street
CHD	Chesterfield
CSW	Chestfield & Swalecliffe
CNO	Chetnole
CCH	Chichester
CIL	Chilham
CHL	Chilworth
CHI	Chingford
CLY	Chinley
CPM	Chippenham
CHP	Chipstead
CRK	Chirk
CIT	Chislehurst
CHK	Chiswick
CHO	Cholsey
CRL	Chorley
CLW	Chorleywood
CHH	Christ's Hospital
CHR	Christchurch
CTW	Church & Oswaldtwistle
CHF	Church Fenton
CTT	Church Stretton
CIM	Cilmeri
CTK	City Thameslink
CLT	Clacton
CLA	Clandon
CPY	Clapham (North Yorkshire)
CLP	Clapham High Street
CLJ	Clapham Junction
CPT	Clapton
CLR	Clarbeston Road
CKS	Clarkston
CLV	Claverdon
CLG	Claygate
CLE	Cleethorpes
CEA	Cleland
CLI	Clifton
CFN	Clifton Down
CLH	Clitheroe
CLK	Clock House
CUW	Clunderwen
CYK	Clydebank
CBC	Coatbridge Central
CBS	Coatbridge Sunnyside
COA	Coatdyke
CSD	Cobham & Stoke D'abernon
CSL	Codsall
CGN	Cogan
COL	Colchester
CET	Colchester Town
CEH	Coleshill Parkway
CLM	Collingham
CLL	Collington
CNE	Colne
CWL	Colwall
CWB	Colwyn Bay
CME	Combe
COM	Commondale
CNG	Congleton
CNS	Conisbrough
CON	Connel Ferry
CEY	Cononley
CNP	Conway Park
CNW	Conwy
COB	Cooden Beach
COO	Cookham
CBR	Cooksbridge
COE	Coombe
COP	Copplestone
CRB	Corbridge
COR	Corby
CKH	Corkerhill Glasgow
CKL	Corkickle
CPA	Corpach
CRR	Corrour
COY	Coryton
CSY	Coseley
COS	Cosford
CSA	Cosham
CGM	Cottingham
COT	Cottingley
CDS	Coulsdon South
COV	Coventry
CWN	Cowden
COW	Cowdenbeath
CRA	Cradley Heath
CGD	Craigendoran
CRM	Cramlington
CRV	Craven Arms
CRW	Crawley
CRY	Crayford
CDI	Crediton
CES	Cressing
CSG	Cressington
CWD	Creswell (Derbys)
CRE	Crewe
CKN	Crewkerne
CWH	Crews Hill
CNR	Crianlarich
CCC	Criccieth
CRI	Cricklewood
CFF	Croftfoot
CFT	Crofton Park
CMR	Cromer
CMF	Cromford
CKT	Crookston Glasgow
CRG	Cross Gates
CFL	Crossflatts
COI	Crosshill
CKY	Crosskeys
CMY	Crossmyloof
CSO	Croston
CRH	Crouch Hill
COH	Crowborough
CWU	Crowhurst
CWE	Crowle
CRN	Crowthorne
CRO	Croy
CYP	Crystal Palace
CUD	Cuddington
CUF	Cuffley
CUM	Culham
CUA	Culrain
CUB	Cumbernauld
CUP	Cupar
CUH	Curriehill
CUX	Cuxton
CMH	Cwmbach
CWM	Cwmbran
CYN	Cynghordy
DDK	Dagenham Dock
DSY	Daisy Hill
DAG	Dalgety Bay
DAL	Dalmally
DAK	Dalmarnock
DAM	Dalmeny
DMR	Dalmuir
DLR	Dalreoch
DLY	Dalry
DLS	Dalston
DLK	Dalston (Kingsland)
DLJ	Dalston Junction
DLT	Dalton
DLW	Dalwhinnie
DNY	Danby
DCT	Danescourt
DZY	Danzey
DAR	Darlington
DAN	Darnall
DSM	Darsham
DFD	Dartford
DRT	Darton
DWN	Darwen
DAT	Datchet
DVN	Davenport
DWL	Dawlish
DWW	Dawlish Warren
DEA	Deal
DEN	Dean
DGT	Deansgate
DPD	Deepdene
DGY	Deganwy
DHN	Deighton
DLM	Delamere
DBD	Denby Dale
DNM	Denham
DGC	Denham Golf Club
DMK	Denmark Hill
DNT	Dent
DTN	Denton
DEP	Deptford
DBY	Derby
DBR	Derby Road
DPT	Devonport
DEW	Dewsbury
DID	Didcot Parkway
DIG	Digby and Sowton
DMH	Dilton Marsh
DMG	Dinas (Mid Glamorgan)
DNS	Dinas Powys
DGL	Dingle Road
DIN	Dingwall
DND	Dinsdale
DTG	Dinting
DSL	Disley
DIS	Diss
DOC	Dockyard
DOD	Dodworth
DOL	Dolau
DLH	Doleham
DLG	Dolgarrog
DWD	Dolwyddelan
DON	Doncaster
DCH	Dorchester South
DCW	Dorchester West
DOR	Dore
DKG	Dorking
DKT	Dorking West
DMS	Dormans
DDG	Dorridge
DVH	Dove Holes
DVP	Dover Priory
DVC	Dovercourt
DVY	Dovey Junction
DOW	Downham Market
DRG	Drayton Green
DYP	Drayton Park
DRM	Drem
DRF	Driffield
DRI	Drigg
DTW	Droitwich Spa
DRO	Dronfield
DMC	Drumchapel
DFR	Drumfrochar
DRU	Drumgelloch
DMY	Drumry
DUD	Duddeston
DDP	Dudley Port
DFI	Duffield
DRN	Duirinish
DST	Duke Street
DUL	Dullingham
DBC	Dumbarton Central
DBE	Dumbarton East
DUM	Dumbreck
DMF	Dumfries
DMP	Dumpton Park
DUN	Dunbar
DBL	Dunblane
DBG	Dunbridge
DCG	Duncraig
DEE	Dundee
DFL	Dunfermline
DFE	Dunfermline Queen Margaret
DKD	Dunkeld & Birnam
DNL	Dunlop
DNO	Dunrobin Castle
DOT	Dunston
DNG	Dunton Green
DHM	Durham
DUR	Durrington-On-Sea
DYC	Dyce
DYF	Dyffryn Ardudwy
EAG	Eaglescliffe
EAL	Ealing Broadway
ERL	Earlestown
EAR	Earley
EAD	Earlsfield
ELD	Earlswood (Surrey)
EWD	Earlswood (West Midlands)
ECR	Croydon
EDY	East Didsbury
EDW	East Dulwich
EFL	East Farleigh
EGF	East Garforth
EGR	East Grinstead
EKL	East Kilbride
EML	East Malling
EMD	East Midlands Parkway
ETL	East Tilbury
EWR	East Worthing
EBN	Eastbourne
EBK	Eastbrook
EST	Easterhouse
ERA	Eastham Rake
ESL	Eastleigh
EGN	Eastrington
EBB	Ebbsfleet International
EBV	Ebbw Vale Parkway
ECC	Eccles
ECS	Eccles Road
ECL	Eccleston Park
EDL	Edale
EDN	Eden Park
EBR	Edenbridge
EBT	Edenbridge Town
EDG	Edge Hill
EDB	Edinburgh
EDP	Edinburgh Park
EDR	Edmonton Green
EFF	Effingham Junction
EGG	Eggesford
EGH	Egham
EGT	Egton
EPH	Elephant & Castle
ELG	Elgin
ELP	Ellesmere Port
ELE	Elmers End
ESD	Elmstead Woods
ESW	Elmswell
ELR	Elsecar
ESM	Elsenham
ELS	Elstree & Borehamwood
ELW	Eltham
ELO	Elton & Orston
ELY	Ely
EMP	Emerson Park
EMS	Emsworth
ENC	Enfield Chase
ENL	Enfield Lock
ENF	Enfield Town
ENT	Entwistle
EPS	Epsom
EPD	Epsom Downs
ERD	Erdington
ERI	Eridge
ERH	Erith
ESH	Esher
EXR	Essex Road
ETC	Etchingham
EUS	Euston
EBA	Euxton Balshaw Lane
EVE	Evesham
EWE	Ewell East
EWW	Ewell West
EXC	Exeter
EXD	Exeter St. David's
EXT	Exeter St. Thomas
EXG	Exhibition Centre Glasgow
EXM	Exmouth
EXN	Exton
EYN	Eynsford
FRB	Fairbourne
FRF	Fairfield
FRL	Fairlie
FRW	Fairwater
FCN	Falconwood
FKG	Falkirk Grahamston
FKK	Falkirk
FOC	Falls Of Cruachan
FMR	Falmer
FAL	Falmouth Docks
FMT	Falmouth Town
FAM	Fambridge
FRM	Fareham
FNB	Farnborough
FNN	Farnborough North
FNC	Farncombe
FNH	Farnham
FNR	Farningham Road
FNW	Farnworth
FAR	Farringdon
FLD	Fauldhouse
FAV	Faversham
FGT	Faygate
FAZ	Fazakerley
FRN	Fearn
FEA	Featherstone
FLX	Felixstowe
FEL	Feltham
FST	Fenchurch Street
FNT	Feniton
FEN	Fenny Stratford
FER	Fernhill
FRY	Ferriby
FYS	Ferryside
FFA	Ffairfach
FIL	Filey
FIT	Filton Abbey Wood
FNY	Finchley Road & Frognal
FPK	Finsbury Park
FIN	Finstock
FSB	Fishbourne
FSG	Fishersgate
FGH	Fishguard Harbour
FSK	Fiskerton
FZW	Fitzwilliam
FWY	Five Ways
FLE	Fleet
FLM	Flimby
FLN	Flint
FLT	Flitwick
FLI	Flixton
FLF	Flowery Field
FKC	Folkestone Central
FKW	Folkestone West
FOD	Ford
FOG	Forest Gate
FOH	Forest Hill
FBY	Formby
FOR	Forres
FRS	Forsinard
FTM	Fort Matilda
FTW	Fort William
FOK	Four Oaks
FOX	Foxfield
FXN	Foxton
FRT	Frant
FTN	Fratton
FRE	Freshfield
FFD	Freshford
FML	Frimley
FRI	Frinton
FZH	Frizinghall
FRD	Frodsham
FRO	Frome
FLW	Fulwell
FNV	Furness Vale
FZP	Furze Platt
GNB	Gainsborough Central
GBL	Gainsborough Lea Road
GCH	Garelochhead
GRF	Garforth
GGV	Gargrave
GAR	Garrowhill
GRS	Garscadden
GSD	Garsdale
GSN	Garston (Hertfordshire)
GSW	Garswood
GRH	Gartcosh
GMG	Garth (Mid-Glamorgan)
GTH	Garth (Powys)
GVE	Garve
GST	Gathurst
GTY	Gatley
GTW	Gatwick Airport
GGJ	Georgemas Junction
GER	Gerrards Cross
GDP	Gidea Park
GFN	Giffnock
GIG	Giggleswick
GBD	Gilberdyke
GFF	Gilfach Fargoed
GIL	Gillingham (Dorset)
GLM	Gillingham (Kent)
GSC	Gilshochill
GIP	Gipsy Hill
GIR	Girvan
GLS	Glaisdale
GCW	Glan Conwy
GLC	Glasgow
GLQ	Glasgow Queen Street
GLH	Glasshoughton
GLZ	Glazebrook
GLE	Gleneagles
GLF	Glenfinnan
GLG	Glengarnock
GLT	Glenrothes with Thornton
GLO	Glossop
GCR	Gloucester
GLY	Glynde
GOB	Gobowen
GOD	Godalming
GDL	Godley
GDN	Godstone
GOE	Goldthorpe
GOF	Golf Street
GOL	Golspie
GOM	Gomshall
GMY	Goodmayes
GOO	Goole
GTR	Goostrey
GDH	Gordon Hill
GOR	Goring & Streatley
GBS	Goring-By-Sea
GTO	Gorton
GPO	Gospel Oak
GRK	Gourock
GWN	Gowerton
GOX	Goxhill
GPK	Grange Park
GOS	Grange-Over-Sands
GTN	Grangetown (South Glamorgan)
GRA	Grantham
GRT	Grateley
GVH	Gravelly Hill
GRV	Gravesend
GRY	Grays
GTA	Great Ayton
GRB	Great Bentley
GRC	Great Chesterford
GCT	Great Coates
GMV	Great Malvern
GMN	Great Missenden
GYM	Great Yarmouth
GNL	Green Lane
GNR	Green Road
GBK	Greenbank
GRL	Greenfaulds
GNF	Greenfield
GFD	Greenford
GNH	Greenhithe
GKC	Greenock Central
GKW	Greenock West
GNW	Greenwich
GEA	Gretna Green
GMD	Grimsby Docks
GMB	Grimsby Town
GRN	Grindleford
GMT	Grosmont
GRP	Grove Park
GUI	Guide Bridge
GLD	Guildford
GSY	Guiseley
GUN	Gunnersbury
GSL	Gunnislake
GNT	Gunton
GWE	Gwersyllt
GYP	Gypsy Lane
HAB	Habrough
HCB	Hackbridge
HKC	Hackney
HAC	Hackney Downs
HKW	Hackney Wick
HDM	Haddenham & Thame Parkway
HAD	Haddiscoe
HDF	Hadfield
HDW	Hadley Wood
HGF	Hag Fold
HGG	Haggerston
HAG	Hagley
HMY	Hairmyres
HAL	Hale
HAS	Halesworth
HED	Halewood
HFX	Halifax
HLG	Hall Green
HID	Hall I' Th' Wood
HLR	Hall Road
HAI	Halling
HWH	Haltwhistle
HMT	Ham Street
HME	Hamble
HNC	Hamilton Central
HNW	Hamilton West
HMM	Hammerton
HMD	Hampden Park
HDH	Hampstead Heath
HMP	Hampton
HMC	Hampton Court
HMW	Hampton Wick
HIA	Hampton-In-Arden
HSD	Hamstead
HAM	Hamworthy
HND	Handborough
HTH	Handforth
HAN	Hanwell
HPN	Hapton
HRL	Harlech
HDN	Harlesden
HRD	Harling Road
HLN	Harlington
HWM	Harlow Mill
HWN	Harlow Town
HRO	Harold Wood
HPD	Harpenden
HRM	Harrietsham
HGY	Harringay
HRY	Harringay Green Lanes
HRR	Harrington
HGT	Harrogate
HRW	Harrow & Wealdstone
HOH	Harrow-On-The-Hill
HTF	Hartford
HBY	Hartlebury
HPL	Hartlepool
HTW	Hartwood
HPQ	Harwich International
HWC	Harwich Town
HSL	Haslemere
HSK	Hassocks
HGS	Hastings
HTE	Hatch End
HAT	Hatfield
HFS	Hatfield & Stainforth
HAP	Hatfield Peverel
HSG	Hathersage
HTY	Hattersley
HTN	Hatton
HAV	Havant
HVN	Havenhouse
HVF	Haverfordwest
HWD	Hawarden
HWB	Hawarden Bridge
HKH	Hawkhead
HDB	Haydon Bridge
HYR	Haydons Road
HYS	Hayes (Kent)
HAY	Hayes & HARLNGTN gp
HYL	Hayle
HYM	Haymarket
HHE	Haywards Heath
HAZ	Hazel Grove
HCN	Headcorn
HDY	Headingley
HDL	Headstone Lane
HDG	Heald Green
HLI	Healing
HHL	Heath High Level
HLL	Heath Low Level
HTC	Heaton Chapel
HBD	Hebden Bridge
HEC	Heckington
HDE	Hedge End
HNF	Hednesford
HEI	Heighington
HLC	Helensburgh Central
HLU	Helensburgh Upper
HLD	Hellifield
HMS	Helmsdale
HSB	Helsby
HML	Hemel Hempstead
HEN	Hendon
HNG	Hengoed
HNL	Henley-In-Arden
HOT	Henley-On-Thames
HEL	Hensall
HFD	Hereford
HNB	Herne Bay
HNH	Herne Hill
HER	Hersham
HFE	Hertford East
HFN	Hertford North
HES	Hessle
HSW	Heswall
HEV	Hever
HEW	Heworth
HEX	Hexham
HYD	Heyford
HHB	Heysham Harbour
HIB	High Brooms
HST	High Street
HWY	High Wycombe
HGM	Higham
HIP	Highams Park
HIG	Highbridge & Burnham
HHY	Highbury & I
HTO	Hightown
HLB	Hildenborough
HLF	Hillfoot
HLE	Hillington East
HLW	Hillington West
HIL	Hillside
HLS	Hilsea
HYW	Hinchley Wood
HNK	Hinckley
HIN	Hindley
HNA	Hinton Admiral
HIT	Hitchin
HGR	Hither Green
HOC	Hockley
HBN	Hollingbourne
HCH	Holmes Chapel
HLM	Holmwood
HOL	Holton Heath
HHD	Holyhead
HLY	Holytown
HMN	Homerton
HYB	Honeybourne
HON	Honiton
HOY	Honley
HPA	Honor Oak Park
HOK	Hook
HOO	Hooton
HPE	Hope (Clwyd)
HOP	Hope (Derbyshire)
HPT	Hopton Heath
HOR	Horley
HBP	Hornbeam Park
HRN	Hornsey
HRS	Horsforth
HRH	Horsham
HSY	Horsley
HIR	Horton In Ribblesdale
HWI	Horwich Parkway
HSC	Hoscar
HGN	Hough Green
HOU	Hounslow
HOV	Hove
HXM	Hoveton & Wroxham
HWW	How Wood (Hertfordshire)
HOW	Howden
HOZ	Howwood
HOX	Hoxton
HYK	Hoylake
HBB	Hubberts Bridge
HKN	Hucknall
HUD	Huddersfield
HUL	Hull
HUP	Humphrey Park
HCT	Huncoat
HGD	Hungerford
HUB	Hunmanby
HNX	Hunts Cross
HUN	Huntingdon
HNT	Huntly
HUR	Hurst Green
HUT	Hutton Cranswick
HUY	Huyton
HYC	Hyde Central
HYT	Hyde North
HKM	Hykeham
HYN	Hyndland
HYH	Hythe
IBM	IBM
IFI	Ifield
IFD	Ilford
ILK	Ilkley
IMW	Imperial Wharf
INC	Ince
INE	Ince & Elton
INT	Ingatestone
INS	Insch
IGD	Invergordon
ING	Invergowrie
INK	Inverkeithing
INP	Inverkip
INV	Inverness
INH	Invershin
INR	Inverurie
IPS	Ipswich
IRL	Irlam
IRV	Irvine
ISL	Isleworth
ISP	Islip
IVR	Iver
IVY	Ivybridge
JEQ	Jewellery Quarter
JOH	Johnston (Dyfed)
JHN	Johnstone
JOR	Jordanhill
KSL	Kearsley
KSN	Kearsney
KEI	Keighley
KEH	Keith
KEL	Kelvedon
KVD	Kelvindale
KEM	Kemble
KMH	Kempston Hardwick
KMP	Kempton Park
KMS	Kemsing
KML	Kemsley
KEN	Kendal
KLY	Kenley
KNE	Kennett
KNS	Kennishead
KNL	Kensal Green
KNR	Kensal Rise
KPA	Kensington Olympia
KTH	Kent House
KTN	Kentish Town
KTW	Kentish Town West
KNT	Kenton
KBK	Kents Bank
KET	Kettering
KWB	Kew Bridge
KWG	Kew Gardens
KEY	Keyham
KYN	Keynsham
KDB	Kidbrooke
KID	Kidderminster
KDG	Kidsgrove
KWL	Kidwelly
KBN	Kilburn High Road
KLD	Kildale
KIL	Kildonan
KGT	Kilgetty
KMK	Kilmarnock
KLM	Kilmaurs
KPT	Kilpatrick
KWN	Kilwinning
KBC	Kinbrace
KGX	King's Cross
KGL	King's Langley
KLN	King's Lynn
KNN	King's Norton
KGN	King's Nympton
KGP	King's Park
KGS	King's Sutton
KGM	Kingham
KGH	Kinghorn
KGE	Kingsknowe
KNG	Kingston
KND	Kingswood
KIN	Kingussie
KIT	Kintbury
KBX	Kirby Cross
KKS	Kirk Sandall
KIR	Kirkby (Merseyside)
KKB	Kirkby in Ashfield
KSW	Kirkby Stephen
KBF	Kirkby-In-Furness
KDY	Kirkcaldy
KRK	Kirkconnel
KKD	Kirkdale
KKM	Kirkham & Wesham
KKH	Kirkhill
KKN	Kirknewton
KWD	Kirkwood
KTL	Kirton Lindsey
KIV	Kiveton Bridge
KVP	Kiveton Park
KNA	Knaresborough
KBW	Knebworth
KNI	Knighton
KCK	Knockholt
KNO	Knottingley
KNU	Knucklas
KNF	Knutsford
KYL	Kyle Of Lochalsh
LDY	Ladybank
LAD	Ladywell
LAI	Laindon
LRG	Lairg
LKE	Lake
LAK	Lakenheath
LAM	Lamphey
LNK	Lanark
LAN	Lancaster
LAC	Lancing
LAW	Landywood
LGB	Langbank
LHO	Langho
LNY	Langley
LGG	Langley Green
LGM	Langley Mill
LGS	Langside
LGW	Langwathby
LAG	Langwith
LAP	Lapford
LPW	Lapworth
LBT	Larbert
LAR	Largs
LRH	Larkhall
LAU	Laurencekirk
LWH	Lawrence Hill
LAY	Layton
LZB	Lazonby & Kirkoswald
LEG	Lea Green
LEH	Lea Hall
LEA	Leagrave
LHM	Lealholm
LMS	Leamington Spa
LSW	Leasowe
LHD	Leatherhead
LED	Ledbury
LEE	Lee
LDS	Leeds
LEI	Leicester
LIH	Leigh (Kent)
LES	Leigh-On-Sea
LBZ	Leighton Buzzard
LEL	Lelant
LTS	Lelant Saltings
LEN	Lenham
LNZ	Lenzie
LEO	Leominster
LET	Letchworth
LEU	Leuchars
LVM	Levenshulme
LWS	Lewes
LEW	Lewisham
LEY	Leyland
LEM	Leyton Midland Road
LER	Leytonstone High Road
LIC	Lichfield City
LTV	Lichfield T V
LID	Lidlington
LHS	Limehouse
LCN	Lincoln
LFD	Lingfield
LGD	Lingwood
LIN	Linlithgow
LIP	Liphook
LSK	Liskeard
LIS	Liss
LVT	Lisvane and Thornhill
LTK	Little Kimble
LTT	Little Sutton
LTL	Littleborough
LIT	Littlehampton
LVN	Littlehaven
LTP	Littleport
LVC	Liverpool Central
LVJ	Liverpool James Street
LIV	Liverpool
LSP	Liverpool South Parkway
LST	Liverpool Street
LSN	Livingston North
LVG	Livingston South
LLA	Llanaber
LBR	Llanbedr
LLT	Llanbister Road
LNB	Llanbradach
LLN	Llandaf
LDN	Llandanwg
LLC	Llandecwyn
LLL	Llandeilo
LLV	Llandovery
LLO	Llandrindod
LLD	Llandudno
LLJ	Llandudno Junction
LLI	Llandybie
LLE	Llanelli
LLF	Llanfairfechan
LPG	Llanfairpwll
LLG	Llangadog
LLM	Llangammarch
LLH	Llangennech
LGO	Llangynllo
LLR	Llanharan
LTH	Llanhilleth
LLS	Llanishen
LWR	Llanrwst
LAS	Llansamlet
LWM	Llantwit Major
LNR	Llanwrda
LNW	Llanwrtyd
LLW	Llwyngwril
LLY	Llwynypia
LHA	Loch Awe
LHE	Loch Eil Outward Bound
LCL	Lochailort
LCS	Locheilside
LCG	Lochgelly
LCC	Lochluichart
LHW	Lochwinnoch
LOC	Lockerbie
LCK	Lockwood
LBG	London Bridge
LOF	London Fields
LRB	London Road Brighton
LON	London Road Guildford
LBK	Long Buckby
LGE	Long Eaton
LPR	Long Preston
LGK	Longbeck
LOB	Longbridge
LNG	Longcross
LGF	Longfield
LND	Longniddry
LPT	Longport
LGN	Longton
LOO	Looe
LTG	Lostock Gralam
LOH	Lostock Hall
LOT	Lostock Parkway
LOS	Lostwithiel
LBO	Loughborough
LGJ	Loughborough Junction
LOW	Lowdham
LSY	Lower Sydenham
LWT	Lowestoft
LUD	Ludlow
LUT	Luton
LTN	Luton Airport Parkway
LUX	Luxulyan
LYD	Lydney
LYE	Lye
LYP	Lymington Pier
LYT	Lymington Town
LYC	Lympstone Commando
LYM	Lympstone Village
LTM	Lytham
MAC	Macclesfield
MCN	Machynlleth
MST	Maesteg
MEW	Maesteg (Ewenny Road)
MAG	Maghull
MDN	Maiden Newton
MAI	Maidenhead
MDB	Maidstone Barracks
MDE	Maidstone
MDW	Maidstone West
MAL	Malden Manor
MLG	Mallaig
MLT	Malton
MVL	Malvern Link
MIA	Manchester Airport
MCO	Manchester Oxford Road
MAN	Manchester
MCV	Manchester Victoria
MNE	Manea
MNG	Manningtree
MNP	Manor Park
MNR	Manor Road
MRB	Manorbier
MAS	Manors
MFT	Mansfield Town
MSW	Mansfield Woodhouse
MCH	March
MRN	Marden
MAR	Margate
MHR	Market Harborough
MKR	Market Rasen
MNC	Markinch
MKT	Marks Tey
MLW	Marlow
MPL	Marple
MSN	Marsden
MSK	Marske
MGN	Marston Green
MTM	Martin Mill
MAO	Martins Heron
MTO	Marton
MYH	Maryhill
MYL	Maryland
MYB	Marylebone
MRY	Maryport
MAT	Matlock
MTB	Matlock Bath
MAU	Mauldeth Road
MAX	Maxwell Park
MAY	Maybole
MZH	Maze Hill
MHS	Meadowhall
MEL	Meldreth
MKM	Melksham
MES	Melton
MMO	Melton Mowbray
MEN	Menheniot
MNN	Menston
MEO	Meols
MEC	Meols Cop
MEP	Meopham
MEY	Merryton
MHM	Merstham
MER	Merthyr Tydfil
MEV	Merthyr Vale
MGM	Metheringham
MCE	MetroCentre
MEX	Mexborough
MIC	Micheldever
MIK	Micklefield
MBR	Middlesbrough
MDL	Middlewood
MDG	Midgham
MLF	Milford (Surrey)
MFH	Milford Haven
MLH	Mill Hill (Lancashire)
MIL	Mill Hill Broadway
MLB	Millbrook (Bedfordshire)
MBK	Millbrook (Hampshire)
MIN	Milliken Park
MLM	Millom
MIH	Mills Hill
MLN	Milngavie
MKC	Milton Keynes Central
MFF	Minffordd
MSR	Minster
MIR	Mirfield
MIS	Mistley
MTC	Mitcham Eastfields
MIJ	Mitcham Junction
MOB	Mobberley
MON	Monifieth
MRS	Monks Risborough
MTP	Montpelier
MTS	Montrose
MRF	Moorfields
MOG	Moorgate
MSD	Moorside
MRP	Moorthorpe
MRR	Morar
MRD	Morchard Road
MDS	Morden South
MCM	Morecambe
MTN	Moreton (Dorset)
MRT	Moreton (Merseyside)
MIM	Moreton-In-Marsh
MFA	Morfa Mawddach
MLY	Morley
MPT	Morpeth
MOR	Mortimer
MTL	Mortlake
MSS	Moses Gate
MOS	Moss Side
MSL	Mossley (Greater Manchester)
MSH	Mossley Hill
MPK	Mosspark
MSO	Moston
MTH	Motherwell
MOT	Motspur Park
MTG	Mottingham
MLD	Mouldsworth
MCB	Moulsecoomb
MFL	Mount Florida
MTA	Mountain Ash
MTV	Mt. Vernon
MOO	Muir Of Ord
MUI	Muirend
MUB	Musselburgh
MYT	Mytholmroyd
NFN	Nafferton
NLS	Nailsea & Backwell
NRN	Nairn
NAN	Nantwich
NAR	Narberth
NBR	Narborough
NVR	Navigation Road
NTH	Neath
NMT	Needham Market
NEI	Neilston
NEL	Nelson
NES	Neston
NET	Netherfield
NRT	Nethertown
NTL	Netley
NBA	New Barnet
NBC	New Beckenham
NBN	New Brighton
NCE	New Clee
NWX	New Cross
NXG	New Cross Gate
NCK	New Cumnock
NEH	New Eltham
NHL	New Holland
NHE	New Hythe
NLN	New Lane
NEM	New Malden
NMC	New Mills Central
NMN	New Mills Newtown
NWM	New Milton
NPD	New Pudsey
NSG	New Southgate
NCT	Newark
NNG	Newark North Gate
NBE	Newbridge
NBY	Newbury
NRC	Newbury Racecourse
NCL	Newcastle
NEW	Newcraighall
NVH	Newhaven Harbour
NVN	Newhaven Town
NGT	Newington
NMK	Newmarket
NWE	Newport (Essex)
NWP	Newport (S.WALES)
NQY	Newquay
NSD	Newstead
NTN	Newton
NTA	Newton Abbot
NAY	Newton Aycliffe
NWN	Newton For Hyde
NTC	Newton St.Cyres
NLW	Newton-Le-Willows
NOA	Newton-On-Ayr
NWR	Newtonmore
NWT	Newtown
NNP	Ninian Park
NIT	Nitshill
NBT	Norbiton
NRB	Norbury
NSB	Normans Bay
NOR	Normanton
NBW	North Berwick
NCM	North Camp
NDL	North Dulwich
NLR	North Llanrwst
NQU	North Queensferry
NRD	North Road
NSH	North Sheen
NWA	North Walsham
NWB	North Wembley
NTR	Northallerton
NMP	Northampton
NFD	Northfield
NFL	Northfleet
NLT	Northolt Park
NUM	Northumberland Park
NWI	Northwich
NRW	Norwich
NWD	Norwood Junction
NOT	Nottingham
NUN	Nuneaton
NHD	Nunhead
NNT	Nunthorpe
NUT	Nutbourne
NUF	Nutfield
OKN	Oakengates
OKM	Oakham
OKL	Oakleigh Park
OBN	Oban
OCK	Ockendon
OLY	Ockley
OKE	Okehampton
OHL	Old Hill
ORN	Old Roan
OLD	Old Street
OLF	Oldfield Park
OLT	Olton
ORE	Ore
OMS	Ormskirk
ORP	Orpington
ORR	Orrell
OPK	Orrell Park
OTF	Otford
OUN	Oulton Broad North
OUS	Oulton Broad South
OUT	Outwood
OVE	Overpool
OVR	Overton
OXN	Oxenholme Lake District
OXF	Oxford
OXS	Oxshott
OXT	Oxted
PAD	Paddington
PDW	Paddock Wood
PDG	Padgate
PGN	Paignton
PCN	Paisley Canal
PYG	Paisley Gil St
PYJ	Paisley St.James
PAL	Palmers Green
PAN	Pangbourne
PNL	Pannal
PTF	Pantyffynnon
PAR	Par
PBL	Parbold
PKT	Park Street
PKS	Parkstone
PSN	Parson Street
PTK	Partick
PRN	Parton
PWY	Patchway
PAT	Patricroft
PTT	Patterton
PEA	Peartree
PMR	Peckham Rye
PEG	Pegswood
PEM	Pemberton
PBY	Pembrey & Burry Port
PMB	Pembroke
PMD	Pembroke Dock
PNY	Pen-Y-Bont
PNA	Penally
PEN	Penarth
PCD	Pencoed
PGM	Pengam
PNE	Penge East
PNW	Penge West
PHG	Penhelig
PNS	Penistone
PKG	Penkridge
PMW	Penmaenmawr
PNM	Penmere
PER	Penrhiwceiber
PRH	Penrhyndeudraeth
PNR	Penrith
PYN	Penryn
PES	Pensarn
PHR	Penshurst
PTB	Pentre-Bach
PNF	Penyffordd
PNZ	Penzance
PRW	Perranwell
PRY	Perry Barr
PSH	Pershore
PTH	Perth
PBO	Peterborough
PTR	Petersfield
PET	Petts Wood
PEV	Pevensey & Westham
PEB	Pevensey Bay
PEW	Pewsey
PIL	Pilning
PIN	Pinhoe
PIT	Pitlochry
PSE	Pitsea
PLS	Pleasington
PLK	Plockton
PLC	Pluckley
PLM	Plumley
PMP	Plumpton
PLU	Plumstead
PLY	Plymouth
POK	Pokesdown
PLG	Polegate
PSW	Polesworth
PWE	Pollokshaws East
PWW	Pollokshaws West
PLE	Pollokshields East
PLW	Pollokshields West
PMT	Polmont
POL	Polsloe Bridge
PON	Ponders End
PYP	Pont-y-Pant
PTD	Pontarddulais
PFR	Pontefract
PFM	Pontefract Monkhill
POT	Pontefract Tanshelf
PLT	Pontlottyn
PYC	Pontyclun
PPL	Pontypool and New Inn
PPD	Pontypridd
POO	Poole
POP	Poppleton
PTG	Port Glasgow
PSL	Port Sunlight
PTA	Port Talbot Parkway
PTC	Portchester
POR	Porth
PTM	Porthmadog
PLN	Portlethen
PLD	Portslade
PMS	Portsmouth & Southsea
PMA	Portsmouth Arms
PMH	Portsmouth
PPK	Possilpark & Parkhouse
PBR	Potters Bar
PFY	Poulton-Le-Fylde
PYT	Poynton
PRS	Prees
PSC	Prescot
PRT	Prestatyn
PRB	Prestbury
PRE	Preston LANCS
PRP	Preston Park
PST	Prestonpans
PTW	Prestwick
PRA	Prestwick Internat'nl Airport
PTL	Priesthill & Darnley
PRR	Princes Risborough
PRL	Prittlewell
PRU	Prudhoe
PUL	Pulborough
PFL	Purfleet
PUR	Purley
PUO	Purley Oaks
PUT	Putney
PWL	Pwllheli
PYL	Pyle
QYD	Quaker's Yard
QPK	Queen's Park (Glasgow)
QPW	Queen's Park (Gt London)
QRP	Queen's Road Peckham
QBR	Queenborough
QRB	Queenstown Road (Battersea)
QUI	Quintrel Downs
RDF	Radcliffe (Nottinghamshire)
RDT	Radlett
RAD	Radley
RDR	Radyr
RNF	Rainford
RNM	Rainham (Essex)
RAI	Rainham (Kent)
RNH	Rainhill
RAM	Ramsgate
RGW	Ramsgreave & Wilpshire
RAN	Rannoch For Kinloch Rannoch
RAU	Rauceby
RAV	Ravenglass
RVB	Ravensbourne
RVN	Ravensthorpe
RWC	Rawcliffe
RLG	Rayleigh
RAY	Raynes Park
RDG	Reading
RDW	Reading West
REC	Rectory Road
RDB	Redbridge
RCC	Redcar Central
RCE	Redcar East
RDN	Reddish North
RDS	Reddish South
RDC	Redditch
RDH	Redhill
RDA	Redland
RED	Redruth
RHM	Reedham (Greater London)
REE	Reedham (Norfolk)
REI	Reigate
RTN	Renton
RET	Retford
RHI	Rhiwbina
RIA	Rhoose (Cardiff Int Airpt)
RHO	Rhosneigr
RHL	Rhyl
RHY	Rhymney
RHD	Ribblehead
RIL	Rice Lane
RMD	Richmond London
RIC	Rickmansworth
RDD	Riddlesdown
RID	Ridgmont
RDM	Riding Mill
RCA	Risca and Pontymister
RIS	Rishton
RBR	Robertsbridge
ROB	Roby
RCD	Rochdale
ROC	Roche
RTR	Rochester
RFD	Rochford
RFY	Rock Ferry
ROG	Rogart
ROR	Rogerstone
ROL	Rolleston
RMB	Roman Bridge
RMF	Romford
RML	Romiley
ROM	Romsey
ROO	Roose
RSG	Rose Grove
RSH	Rose Hill (Marple)
ROS	Rosyth
RMC	Rotherham Central
ROE	Rotherhithe
RNR	Roughton Road
RLN	Rowland's Castle
ROW	Rowley Regis
RYB	Roy Bridge
RYN	Roydon
RYS	Royston
RUA	Ruabon
RUF	Rufford
RUG	Rugby
RGT	Rugeley Town
RGL	Rugeley Trnt Val
RUN	Runcorn
RUE	Runcorn East
RKT	Ruskington
RUS	Ruswarp
RUT	Rutherglen
RYD	Ryde Esplanade
RYP	Ryde Pier Head
RYR	Ryde St.John's Road
RRB	Ryder Brow
RYE	Rye
RYH	Rye House
SFD	Salford
SLD	Salford Crescent
SAF	Salfords
SAH	Salhouse
SAL	Salisbury
SAE	Saltaire
STS	Saltash
SLB	Saltburn
SLT	Saltcoats
SAM	Saltmarshe
SLW	Salwick
SMC	Sampford Courtenay
SNA	Sandal And Agbrigg
SDB	Sandbach
SNR	Sanderstead
SDL	Sandhills
SND	Sandhurst
SDG	Sandling
SAN	Sandown
SDP	Sandplace
SAD	Sandwell & Dudley
SDW	Sandwich
SDY	Sandy
SNK	Sankey For Penketh
SQH	Sanquhar
SRR	Sarn
SDF	Saundersfoot
SDR	Saunderton
SAW	Sawbridgeworth
SXY	Saxilby
SAX	Saxmundham
SCA	Scarborough
SCT	Scotscalder
SCH	Scotstounhill
SCU	Scunthorpe
SML	Sea Mills
SEF	Seaford
SFL	Seaforth & Litherland
SEA	Seaham
SEM	Seamer
SSC	Seascale
SEC	Seaton Carew
SRG	Seer Green
SBY	Selby
SRS	Selhurst
SEL	Sellafield
SEG	Selling
SLY	Selly Oak
SET	Settle
SVK	Seven Kings
SVS	Seven Sisters
SEV	Sevenoaks
SVB	Severn Beach
STJ	Severn Tunnel Junction
SDE	Shadwell
SFR	Shalford
SHN	Shanklin
SHW	Shawford
SHL	Shawlands
SSS	Sheerness-On-Sea
SHF	Sheffield
SED	Shelford
SNF	Shenfield
SEN	Shenstone
SPH	Shepherd's Well
SPB	Shepherds Bush
SPY	Shepley
SHP	Shepperton
STH	Shepreth
SHE	Sherborne
SIE	Sherburn-In-Elmet
SHM	Sheringham
SLS	Shettleston
SDM	Shieldmuir
SFN	Shifnal
SHD	Shildon
SHI	Shiplake
SHY	Shipley
SPP	Shippea Hill
SIP	Shipton
SHB	Shirebrook (Derbys)
SHH	Shirehampton
SRO	Shireoaks
SRL	Shirley
SRY	Shoeburyness
SHO	Sholing
SDC	Shoreditch High Street
SEH	Shoreham (Kent)
SSE	Shoreham-By-Sea
SRT	Shortlands
SHT	Shotton
SHS	Shotts
SHR	Shrewsbury
SID	Sidcup
SIL	Sileby
SIC	Silecroft
SLK	Silkstone Common
SLV	Silver Street
SVR	Silverdale
SIN	Singer
SIT	Sittingbourne
SKG	Skegness
SKE	Skewen
SKI	Skipton
SGR	Slade Green
SWT	Slaithwaite
SLA	Slateford
SLR	Sleaford
SLH	Sleights
SLO	Slough
SMA	Small Heath
SAB	Smallbrook Junction
SGB	Smethwick Galton Bridge
SMR	Smethwick
SMI	Smitham
SMB	Smithy Bridge
SNI	Snaith
SDA	Snodland
SWO	Snowdown
SOR	Sole Street
SOL	Solihull
SYT	Somerleyton
SAT	South Acton
SBK	South Bank
SBM	South Bermondsey
SCY	South Croydon
SES	South Elmsall
SGN	South Greenford
SGL	South Gyle
SOH	South Hampstead
SOK	South Kenton
SMO	South Merton
SOM	South Milford
SRU	South Ruislip
STO	South Tottenham
SWS	South Wigston
STL	Southall
SOA	Southampton Airport (Parkway)
SOU	Southampton
SOB	Southbourne
SBU	Southbury
SEE	Southease
SOC	Southend Central
SOE	Southend
SOV	Southend Victoria
SMN	Southminster
SOP	Southport
SWK	Southwick
SOW	Sowerby Bridge
SPA	Spalding
SBR	Spean Bridge
SPI	Spital
SPO	Spondon
SPN	Spooner Row
SRI	Spring Road
SPR	Springburn
SPF	Springfield
SQU	Squires Gate
SAA	St.Albans Abbey
SAC	St.Albans City
SAR	St.Andrew's Road
SAS	St.Annes-On-The-Sea
SAU	St.Austell
SBS	St.Bees
SBF	St.Budeaux Ferry Road
SBV	St.Budeaux Victoria Road
SCR	St.Columb Road
SDN	St.Denys
SER	St.Erth
SGM	St.Germans
SNH	St.Helens Central
SHJ	St.Helens Junction
SIH	St.Helier
SIV	St.Ives
SJP	St.James' Park
SJS	St.James' Street
SAJ	St.John's
SKN	St.Keyne
SLQ	St.Leonards Warrior Square
SMG	St.Margaret's (Greater London)
SMT	St.Margaret's (Hertfordshire)
SMY	St.Mary Cray
STM	St.Michaels
SNO	St.Neots
STP	St.Pancras
STA	Stafford
SNS	Staines
SLL	Stallingborough
SYB	Stalybridge
SMD	Stamford
SMH	Stamford Hill
SFO	Stanford-Le-Hope
SNT	Stanlow & Thornton
SSD	Stansted
SST	Stansted Mountfitchet
SPU	Staplehurst
SRD	Stapleton Road
SBE	Starbeck
SCS	Starcross
SVL	Staveley (Cumbria)
SCF	Stechford
SON	Steeton & Silsden
SPS	Stepps
SVG	Stevenage
STV	Stevenston
SWR	Stewartby
STT	Stewarton
STG	Stirling
SPT	Stockport
SKS	Stocksfield
SSM	Stocksmoor
STK	Stockton
SKM	Stoke Mandeville
SKW	Stoke Newington
SOT	STOKE ON TRENT
SNE	Stone
SCG	Stone Crossing
SBP	Stonebridge Park
SOG	Stonegate
STN	Stonehaven
SHU	Stonehouse
SNL	Stoneleigh
SBJ	Stourbridge Junction
SBT	Stourbridge Town
SMK	Stowmarket
STR	Stranraer
SRA	Stratford
SFA	Stratford International
SAV	Stratford U
STC	Strathcarron
STW	Strawberry Hill
STE	Streatham
SRC	Streatham Common
SRH	Streatham Hill
SHC	Streethouse
SRN	Strines
STF	Stromeferry
SOO	Strood
STD	Stroud
STU	Sturry
SYA	Styal
SUY	Sudbury
SUD	Sudbury & Harrow Road
SDH	Sudbury Hill Harrow
SUG	Sugar Loaf
SUM	Summerston
SUU	Sunbury
SUN	Sunderland
SUP	Sundridge Park
SNG	Sunningdale
SNY	Sunnymeads
SUR	Surbiton
SQE	Surrey Quays
SUO	Sutton (Surrey)
SUT	Sutton Coldfield
SUC	Sutton London
SPK	Sutton Parkway
SWL	Swale
SAY	Swanley
SWM	Swanscombe
SWA	Swansea
SNW	Swanwick
SWY	Sway
SWG	Swaythling
SWD	Swinderby
SWI	Swindon (WILTS)
SWE	Swineshead
SNN	Swinton (Greater Manchester)
SWN	SWINTON  S YORKS
SYD	Sydenham
SYH	Sydenham Hill
SYL	Syon Lane
SYS	Syston
TAC	Tackley
TAD	Tadworth
TAF	Taffs Well
TAI	Tain
TLC	Tal-y-Cafn
TAL	Talsarnau
TLB	Talybont
TAB	Tame Bridge Parkway
TAM	Tamworth
TAP	Taplow
TAT	Tattenham Corner
TAU	Taunton
TAY	Taynuilt
TED	Teddington
TEA	Tees-Side Airport
TGM	Teignmouth
TFC	Telford Central
TMC	Templecombe
TEN	Tenby
TEY	Teynham
THD	Thames Ditton
THA	Thatcham
THH	Thatto Heath
THW	The Hawthorns
TLK	The Lakes
THE	Theale
TEO	Theobalds Grove
TTF	Thetford
THI	Thirsk
TBY	Thornaby
TNN	Thorne North
TNS	Thorne South
THO	Thornford
THB	Thornliebank
TNA	Thornton Abbey
TTH	Thornton Heath
THT	Thorntonhall
TPB	Thorpe Bay
TPC	Thorpe Culvert
TLS	Thorpe-le-Soken
TBD	Three Bridges
TOK	Three Oaks
THU	Thurgarton
THC	Thurnscoe
THS	Thurso
TRS	Thurston
TIL	Tilbury Town
THL	Tile Hill
TLH	Tilehurst
TIP	Tipton
TIR	Tir-Phil
TIS	Tisbury
TVP	Tiverton Parkway
TOD	Todmorden
TOL	Tolworth
TPN	Ton Pentre
TON	Tonbridge
TDU	Tondu
TNF	Tonfanau
TNP	Tonypandy
TOO	Tooting
TOP	Topsham
TQY	Torquay
TRR	Torre
TOT	Totnes
TOM	Tottenham Hale
TTN	Totton
TWN	Town Green
TRA	Trafford Park
TRF	Trefforest
TRE	Trefforest Estate
TRH	Trehafod
TRB	Treherbert
TRY	Treorchy
TRM	Trimley
TRI	Tring
TRD	Troed-Y-Rhiw
TRN	Troon
TRO	Trowbridge
TRU	Truro
TUL	Tulloch
TUH	Tulse Hill
TBW	Tunbridge Wells
TUR	Turkey Street
TUT	Tutbury & Hatton
TWI	Twickenham
TWY	Twyford
TYC	Ty Croes
TGS	Ty Glas
TYG	Tygwyn
TYL	Tyndrum Lower
TYS	Tyseley
TYW	Tywyn
UCK	Uckfield
UDD	Uddingston
ULC	Ulceby
ULL	Ulleskelf
ULV	Ulverston
UMB	Umberleigh
UNI	University
UHA	Uphall
UPL	Upholland
UPM	Upminster
UPH	Upper Halliford
UHL	Upper Holloway
UTY	Upper Tyndrum
UWL	Upper Warlingham
UPT	Upton
UPW	Upwey
URM	Urmston
UTT	Uttoxeter
VAL	Valley
VXH	Vauxhall
VIC	Victoria
VIR	Virginia Water
WDO	Waddon
WAD	Wadhurst
WFL	Wainfleet
WKK	Wakefield Kirkgate
WKF	WAKEFIELD
WKD	Walkden
WLG	Wallasey Grove Road
WLV	Wallasey Village
WLT	Wallington
WAF	Wallyford
WAM	Walmer
WSL	Walsall
WDN	Walsden
WLC	Waltham Cross
WHC	Walthamstow Central
WMW	Walthamstow
WAO	Walton (Merseyside)
WON	Walton-On-Naze
WAL	Walton-On-Thames
WAN	Wanborough
WSW	Wandsworth Common
WWR	Wandsworth Road
WNT	Wandsworth Town
WNP	Wanstead Park
WPE	Wapping
WBL	Warblington
WAR	Ware
WRM	Wareham
WGV	Wargrave
WMN	Warminster
WNH	Warnham
WBQ	Warrington Bank Quay
WAC	Warrington
WRW	Warwick
WRP	Warwick Parkway
WTO	Water Orton
WBC	Waterbeach
WTR	Wateringbury
WAT	Waterloo
WAE	Waterloo (East)
WLO	Waterloo (Merseyside)
WFH	Watford High Street
WFJ	Watford Junction
WFN	Watford North
WTG	Watlington
WAS	Watton-At-Stone
WNG	Waun-gron Park
WAV	Wavertree Technology Park
WEE	Weeley
WET	Weeton
WMG	Welham Green
WLI	Welling
WEL	Wellingborough
WLN	Wellington
WLP	Welshpool
WGC	Welwyn Garden City
WLW	Welwyn North
WEM	Wem
WMB	Wembley Central
WCX	Wembley Stadium
WMS	Wemyss Bay
WND	Wendover
WNN	Wennington
WSA	West Allerton
WBP	West Brompton
WBY	West Byfleet
WCL	West Calder
WCY	West Croydon
WDT	West Drayton
WDU	West Dulwich
WEA	West Ealing
WEH	West Ham
WHD	West Hampstead
WHP	West Hampstead Thameslink
WHR	West Horndon
WKB	West Kilbride
WKI	West Kirby
WMA	West Malling
WNW	West Norwood
WRU	West Ruislip
WRN	West Runton
WLD	West St Leonards
WSU	West Sutton
WWI	West Wickham
WWO	West Worthing
WSB	Westbury
WCF	Westcliff
WCB	Westcombe Park
WHA	Westenhanger
WTA	Wester Hailes
WFI	Westerfield
WES	Westerton
WGA	Westgate-On-Sea
WHG	Westhoughton
WNM	Weston Milton
WSM	Weston-Super-Mare
WRL	Wetheral
WYB	Weybridge
WEY	Weymouth
WBR	Whaley Bridge
WHE	Whalley
WTS	Whatstandwell
WFF	Whifflet
WHM	Whimple
WNL	Whinhill
WHN	Whiston
WTB	Whitby
WCH	Whitchurch (Hampshire)
WTC	Whitchurch (Salop)
WHT	Whitchurch (South Glamorgan)
WHL	White Hart Lane
WNY	White Notley
WCA	Whitechapel
WCR	Whitecraigs
WTH	Whitehaven
WTL	Whitland
WBD	Whitley Bridge
WTE	Whitlock's End
WHI	Whitstable
WLE	Whittlesea
WLF	Whittlesford
WTN	Whitton
WWL	Whitwell (Derbys)
WHY	Whyteleafe
WHS	Whyteleafe South
WCK	Wick
WIC	Wickford
WCM	Wickham Market
WDD	Widdrington
WID	Widnes
WMR	Widney Manor
WGN	Wigan
WGW	Wigan Wallgate
WGT	Wigton
WMI	Wildmill
WIJ	Willesden Jn
WLM	Williamwood
WIL	Willington
WMC	Wilmcote
WML	Wilmslow
WNE	Wilnecote
WIM	Wimbledon
WBO	Wimbledon Chase
WSE	Winchelsea
WIN	Winchester
WNF	Winchfield
WIH	Winchmore Hill
WDM	Windermere
WNC	Windsor & Eton Central
WNR	Windsor & Eton Riverside
WNS	Winnersh
WTI	Winnersh Triangle
WSF	Winsford
WSH	Wishaw
WTM	Witham
WTY	Witley
WTT	Witton
WVF	Wivelsfield
WIV	Wivenhoe
WOB	Woburn Sands
WOK	Woking
WKM	Wokingham
WOH	Woldingham
WVH	Wolverhampton
WOL	Wolverton
WOM	Wombwell
WDE	Wood End
WST	Wood Street
WDB	Woodbridge
WGR	Woodgrange Park
WDL	Woodhall
WDF	Woodham Ferrers
WDH	Woodhouse
WDS	Woodlesford
WLY	Woodley
WME	Woodmansterne
WSR	Woodsmoor
WOO	Wool
WLS	Woolston
WWA	Woolwich Arsenal
WWD	Woolwich Dockyard
WWW	Wootton Wawen
WOF	Worcester Foregate Street
WCP	Worcester Park
WOS	Worcester
WKG	Workington
WRK	Worksop
WOR	Worle
WPL	Worplesdon
WRT	Worstead
WRH	Worthing
WRB	Wrabness
WRY	Wraysbury
WRE	Wrenbury
WRS	Wressle
WXC	Wrexham Central
WRX	Wrexham
WYE	Wye
WYM	Wylam
WYL	Wylde Green
WMD	Wymondham
WYT	Wythall
YAL	Yalding
YRD	Yardley Wood
YRM	Yarm
YAE	Yate
YAT	Yatton
YEO	Yeoford
YVJ	Yeovil Junction
YVP	Yeovil Pen Mill
YET	Yetminster
YNW	Ynyswen
YOK	Yoker
YRK	York
YRT	Yorton
YSM	Ystrad Mynach
YSR	Ystrad Rhondda